[
    ["W"    , "R"    , "R"    , "C"    , "R"    , "R"    , "C"    , "R"    , "R"    , "C"    , "R"    , "R"    , "W"],
    ["W"    , "P"    , "P"    , "R"    , "P"    , "P"    , "R"    , "P"    , "P"    , "R"    , "P"    , "P"    , "W"],
    ["W"    , "P"    , "P"    , "R"    , "P"    , "P"    , "R"    , "P"    , "P"    , "R"    , "P"    , "P"    , "W"],
    ["C"    , "R"    , "R"    , "C"    , "R"    , "R"    , "C"    , "R"    , "R"    , "C"    , "R"    , "R"    , "C"],
    ["W"    , "P"    , "P"    , "R"    , "P"    , "P"    , "R"    , "P"    , "P"    , "R"    , "P"    , "P"    , "W"],
    ["W"    , "P"    , "P"    , "R"    , "P"    , "P"    , "R"    , "P"    , "P"    , "R"    , "P"    , "P"    , "W"],
    ["W"    , "R"    , "R"    , "C"    , "R"    , "R"    , "C"    , "R"    , "R"    , "C"    , "R"    , "R"    , "W"]
]